77777777777777777
90000000000000008
90102210001220108
90225220302252208
90240000300505208
90440442325005508
90101012321015108
90240420302505008
90220042325015208
90122420302522108
90002242325220008
90101222322210108
90000022322000008
90101000000010108
66666666666666666